■■■■■□□■■■■
■■■■■□■■■■■
■□□□☆□■■■■■
■■■■□■■■■■■
■■■□□■■■■■■